1111111111111111111111111111111
111111111111PE11111111111111C11
1111111111111111111111111111111
