111111111111111111111111
1000000P000000000000000 
100E000000000000C0000001
111111111111111111111111