111111111111111111111111
10000000000P0000000000001
100E000000000000C0000001
111111101111111111111111