1111111111111
10C00E00N0001
100C000000P01
1111111111111
