111111111111111111111111111111111111111
1000000P000000000000000000C000000000001
1000000000000000C00000000000000C0000001
111111111111111111111111111111111111111
