N    ./Tex/N.xpm
WE ./Tex/W.xpm
EA ./Tex/E.xpm
SO ./Tex/Si.xpm

F 63,34,4
C 136,66,29

        1111111111111111111111   
        1000000000110000000001111
        1011000001110000000000001
        1001000000000000000000001
111111111011000001110000000000001
100000000011000001110111111111111
11110111111111011100000010001
11110111111111011101010010001
11000000110101011100000000001
10000000000000001100000010001
10000000000000001101010010001
11000001110101011111011110N0111
11110111 1110101 101111010001
11111111 1111111 111111111111
