NO ./Tex/4096_forestNORTH.xpm
SO ./Tex/4096_forestSOUTH.xpm
WE ./Tex/64_Exi.xpm
EA ./Tex/2048_clay.xpm

F 220,100,0
C 225,30,0

1111111111111111111111111111111
1010100000100100000000000000001
1010001101100111010111111110111
10111001000001S1110100000010101
1000111111000000010111011110101
1010000001111000010101010000001
1010000000000000011101011101101
1111111111111000000001001001001
1000000100000000000111101111101
1011100101011000111100000000001
1010000001001100010111111000001
1110111111100100010101010000001
1000101000000111000100010000001
1011101100010100001110110001111
1010100111011111001010000000001
1010000000000100000010000000001
1111111111111111111111111111111
