NO ./Tex/4096_forestNORTH.xpm
SO ./Tex/4096_forestSOUTH.xpm
WE ./Tex/64_Exi.xpm
EA ./Tex/2048_clay.xpm

F 220,100,0
C 225,30,0

1111111111111111111111111111111111
1000000000000000000000000000000001
1010010100100011111001000000010101
101001001010101   1001000000010101
1000000000000011111000000000000001
100E000000000000000000000000000001
1111111111111111111111111111111111
