NO ./Tex/4096_forestNORTH.xpm
SO ./Tex/4096_forestSOUTH.xpm
WE ./Tex/64_Exi.xpm
EA ./Tex/2048_clay.xpm

F 220,100,0
C 225,30,0

1111111111111111111111111111111111
1000000000000000001000001000000001
1001010100100000101001111000010101
1001010010101010001001000000110101
10010000100010001110000010E0100001
1101000010000000000000001000100001
1111111111111111111111111111111111
