NO ./Tex/4096_forestNORTH.xpm
SO ./Tex/4096_forestSOUTH.xpm
WE ./Tex/64_Exi.xpm
EA ./Tex/2048_clay.xpm

F 220,100,0
C 225,30,0

1111111111111
1001000000001
1000011111001
100011S000001
1111111111111
